Date Created: 2020-04-15  23:36:32
Date of Last Change: 2020-04-15  23:36:35
::::::::::::::::::::::::::::::::::::::::::::::::::::::::::::


Level

 #####   #####
 #   #####   #
 #  $     $  #
 #**.**$**.**#
 #   . . .   #
 #$.$.$*$.$.$#
 #.$*$.@.$*$.#
##$.$.$*$.$.$##
#   .  .  .   #
#**.***$***.**#
#  $       $  #
#   #######   #
#####     #####

Solution 3630/734
lDurrDulldldllllDRdRRRRRRRllllllluurrruruUdrrUdllululldDuurrdrddldllUU
ddrrururrdrdrrrrDulluUddllulullululllURuRRRRRlllllddrUdrdrddldlluulUdr
URldddDuuulDrdrruLLddlddrUrUUddlluRurruruuLululDDurrdrddldlluUURldddrr
uLrruuLDLddrUruululDrrddldlldlluRURRURlddLulDrruuruulDlDDrdrUllldRddrr
rrUdllUdlluulDrdrruLLdrrrruLLdlluuurrrDulDulluurrrDDlUrrrdLuluLddllddd
rrrruUUdddlllluuurrdRluurDrDulllluuRurDlDRluuuluurDDDrdddrrruuLrddlllu
lluUrrdLrddrrruulLLddrrrrdrruLLLLruullldllddddrrrrrrUUddlllllluuuurrur
rrddlULLrrdrRllulluullUdrrddrrrdrdddlllllluuuuURllDrddddrrrrrruuullull
dRurrdrdddlllllluuuRldddrrrrrruuululllLrrrrdrdrrdLrurrdLddrUluLrddlUru
uluurDDllluluururrrDuUdllldlddrRllulldRuruLuLrddllluuuurrrDDuulllddddd
ldddrrrrrrRUUrruUddllluLuurDRDDuulldRullllluuuurrrddlDuruulllddddrRRRu
ruLdddrUddrrruuLLDldRullulldRuruurrDDLdLUlldRullldRluuuuurrDDRRlluulld
dddrrUUddllulldRRlddlUrddddllURdrUUUUdllDurDuurrrdLuuuuuurrrddlddrddLr
uLuuuruullldddddllddrdrrrrUUddlllldllUdrUrrrrrrrrRdrruLLLLLLLLLLrrrruu
luuuuruullldddddlDruuulDulDrruuullDurDruurrrddlLLrrddrrrruuLLLLddddrUl
uuurrrrddlddLruLurrrrddLLrULullddRRurruLLddlluRRurrddLLuuuurrDDlldlluR
RuullllddRRlluuruurDldRllddrrdrruuuuLLdRurDrruLLruulDrddllluuRRurDurDl
lllddllddrrdrrdrrUUddllullulluurruullllddRRddrrUUUdddlluulluurrrRRRlll
lllddrrRlddrruUdddrruLdlUrrddrruuLLdlldRRlluullddRddlllUUUUddddrrruuRl
ddrUUlluurDDrddlllluuuRRlldddldlluRRRuullDRddlUruururrurrDDllulluRRuul
DDuuluurrDDllulldRururrddlddllUUluRdddrddlllDRurruuruuruullullDurDrrrd
dlddlluuRDuURuLdddrUddrddLLLDuUURddrruLUlldddlluRRuulDrRlddlddrUUUUlDD
uurruuullDDDuRdrUrrdLulldRurrddrruuLLLLdlluuurrrrDDrrdrruLLLLuurrrDDuu
llllllldddrdRRRUUddlluuRRlldlluuurrrrrrrddlddLLLLullDRdddllURdrUUUlDrd
dlluRuurRldlddrUrRRRRRRRdrruLLLLLLLLLLdlUUUUdrrDullddrRRRRRRRRdrruLLLL
LLLLLLdlUrruuuurrddrruuruullllllldDuurrrrrrrddlddlDuluullddllDurrddldl
luRuRlddrUUdrrrRuuruuruulllllllddDDDuuuuurruurrrDulllddlldddddrdrrrruu
ruuruulLLLLrrrrrddlddlluuUdddrruuUdddlluuuRuuulllddrRdrUlddddrruuruLdd
dlluuuulluuulldDDDDDDlDRuuuRRlluuuuurrdddrrddddrddlllldllURuuuurrddLru
ulluuuuurrdddrrddddrddlllLdlluRuUrruulluuuuurrdddrrddddrddlllLdlUrrrrr
uuluuuulluuulldddddrrddllUUddrDullDRurrRRuuuulluurrrrrDDLddddLLLLuullU
UddrrddLrrrrddlllLdllURuUrruulluuRRllddrrddllUdrrrrrddlllLUluRddrrrruu
llLrrrruuuuruulllllddDDuuuurrrrrddlddddlddlllluluuUdddrdrrrruuluuRlddr
ddlllluluuurruuuurrrrrddldDuuruulllllddddRRddllUdrruulLuullDDRRddrruuL
LuuuurrrrrddlddLLddrddlllluluUddrdrrrruuluuuuLrddrruuLLddddlluuuURRlld
dRluurrdDllddrrrddlllluluuURRddLdddlluRdrUluUddrrrrrRRRRdrruLLLLLLLLLL
dlUrrrrruullllllDurrDulldRurrrrrddlllULulldRRlddrUdllUrrrrrruullLuullD
DuurruurrddrrrrddLLLrrruulllluullddddrRRllluullddRDullDRdRluurRuuuurrd
drDDlUULLddllddrRRRRUUlLrrddllllldlUrrrrrruullLuurrrrrrddlLLLuurruurrD
DuuluurDDuuurrdLulDlddlddllddrddRRRRdrruLLLLLLLLLLrrrruuluurrrrrrddDuu
ullllllddrddrrrrdrruLuuuulllluurrrrDDllUdrruulLddlluRluRuurrrDDlLrruul
lldDlddrUUlLLrrddllddrrUUruulllDDrrddlddlllldlluRuuuuRRRRlluullDurrddr
ruurrrddlddlddlllLrrrruuruuruurrUdlUdlddrrUdrUlLullllddRRRRllddlddlllU
UUdRRUUdRDllluRldddldlluRuuRRRlddLruulldRddlUruurruurrddLruulldldlddrr
rrUUlLrrddrrrRdrruLLLLLLLLLLdlluRdrUrrrruulluurrrrrurrdDDLLrrDuuuulldl
llllddrrddrrrrdrruLLLLLLLruulluurrDDuLurrrrurrdddllUdrruuullullllDDuur
rrrdrrdddlluUddrrddlllllUUrRRuuRurDDDDuuullddlllddrrrrdrruLuuuullllllu
urrrrDullllddrrrRddllllUUrrrruuurrDDlUlddddlllddrrrRdrruLuuuLUdrdLLruu
lllllddrddrrrRdrUllllluuluurrrrrdrUllllllddrddrrrrUUruulluullllDDrDDuu
rUdlluurRddrruurruuullDurrdddllddlllddlUUrrrrrrddlddllllUUddlLLLdlluRR
RRRRRRRRdrruLdlUlllluuluurrrrrrddllLLrrrruulllluullDurrddrrrrddllllUdr
rrruullDuuurrDLulDrruuuulldRurDlDDuullllDulllulldRRRRRRRRurD
